
R  800 600

C   77, 54, 45
F   45, 48, 51


NO  ./pics/door_big02.xpm
SO  ./pics/hell_bricks06.xpm
WE  ./pics/enpro_wall08.xpm
EA  ./pics/WOODAD.xpm
S   ./pics/3sprite.xpm



  111111111111111111111111111111
 10000000000000000000000000000001
10000000000000000000000000000111
10000000000000002000000000000001                 111111
10002000000000000000002000011111111        111111000011111111
 10000000000000011111111100000000001         111100210000000011111
  1000000000011110000200W000000000111         111100111111110000011
 1000000000200020000000000000000001             1000000000111110111       11111
1000000000000000000000001000001111              10111110000000000001        1011 1
100000000000000000000000000000111              101111111100111111001        101
10000002000000000000000000000001               101      101     110111      101
10000000000000000000002000000001               101      101    11001         101
11111111111111111111111111000111               101       1   11000111       101
                        110001111111111111111111011          10011          101
                        11110000000000000000000001111        101            101
                        1111111111111111111100111111111111111101  1111111111101
                                            10000000000000000001    10000000001
                                            11111111111111111111    11111111111
